supply_area={
	id=271
	name="SUPPLYAREA_271"
	value=8
	states={
		600 606 620 607 749 750
		8120 8121 8122 8123 8124 8125 8126 8127 8128 8129 8130 8131 8132 8133 8134 8135 8136 8137 8138 8139 8140 8141 8142 8143 8144 8145 8146 
		8208 8209 8210 8211 8212 8213 8214 8215 8216 8217 8218 8219 8220 8221 8222 8223 8224 
		8225 8226 8227 8228 8229 8230 8231 8232 8233 8234 8235 8236 8237 8238 8239 8240 8241 8242 8243 8244 8245 8246 8247 8248 8249 8250 8251 8252 
		8422 8423 8424 8425 8426 8427 8428 8429 8430 8431 8432 8433 8434 8435 8436 8437 8438 8439 8440 8441 
		9604 9605 9606 9607 9608 9609 9610 9611 9612 9613 
		9620 9621 9622 9623 9624 9625 9626 9627 9628 9629 9630 9631 
	}
}
