supply_area={
	id=309
	name="SUPPLYAREA_309"
	value=6
	states={
		586 405 589 732 742 
		5355 5356 5357 5358 5359 5360 5361 5362 5363 5364 5365 
		7831 7832 7833 7834 7835 7836 7837 7838 7839 
		7879 7880 7881 7882 7883 7884 7885 7886 7887 7888 7889 7890 7891 7892 7893 7894 7895 7896 
		9479 9480 9481 9482 9483 9484 9485 9486 9487 9488 9489 9490 9491 9492 9493 9494 9495 9496 
		9561 9562 9563 9564 9565 9566 9567 9568 9569 9570 9571 
	}
}
